Adelajda	Adela, Ada	Adelaide
Adriana	Ada, Adusia	Adriana
Adrianna	Ada, Adusia	Adrienne
Agata	Aga, Agatka, Ata, Agusia	Agatha
Agnieszka	Aga, Jagna, Jagienka, Agusia	Agnes
Aleksandra	Ola, Olka, Ala	Alexandra, Alexis
Aleksja	Ala, Ola	Alexia
Alicja	Ala	Alice, Alicia
Alina	Alinka, Ala	Alina
Amanda	Amandzia	Amanda, Mandy
Amelia	Amelka, Amelcia	Amelie
Anastazja	Nastka	Anastasia, Stacy
Andrea	Andzia, Rea	Andrea
Andrzeja	Andzia	Andrea
Aneta	Anetka	Annette
Angela	Angelka	Angela
Angelika	Angela, Andzia	Angelica
Angelina	Angelinka	Angelina
Aniela	Anielka	Angela
Anita	Anitka, Anicia	Anita
Anna	Ania, Anka, Andzia, Anusia, Aneczka	Ann, Anne, Anna
Antonina	Antosia, Tosia	Antoinette
Apolonia	Pola	 
Arleta	Arletka	Arletta
Aurelia	Aurela, Rela, Relka	Aurelia
Balbina	Balbinka	Balbina
Barbara	Basia, Barbarka, Baśka	Barbara
Beata	Beatka	Beata
Berenika	Berenisia, Nika	Berenice
Bogna	Bodzia, Bogusia	 
Bogumiła	Bogusia, Miłka	 
Bogusława	Bogusia, Boguśka, Gusia	 
Bożena	Bożenka	 
Brygida	Brygidka	Bridget
Cecylia	Cecylka, Cyla, Cesia	Cicely, Cilly
Celina	Celinka, Cesia, Ceśka	Celine
Czesława	Czesia, Cześka	 
Dagmara	Daga, Dagusia	Dagmar
Daniela	Dana	Daniela
Danuta	Danka, Danusia	Dana, Donata
Daria	Darka, Darusia, Darunia, Dana	Daria
Deksteryn	Deks, Dyksy	Dexterine
Dominika	Dominisia, Dominiczka, Domi, Domisia, Nika, Doma	Dominique
Donata	Dona, Donka	Donata
Dorota	Dorotka, Dorocia	Dorothy
Dżesika	Dżesi	Jessica
Edyta	Edytka, Edzia	Edith
Eleonora	Ela, Norka	Eleanor
Eliza	Elizka	Eliza, Elise
Elżbieta	Ela, Elka, Elżbietka, Elżunia, Elza	Elizabeth, Elisabeth
Emilia	Emilka, Emi	Emily
Eugenia	Genia, Gienia	Eugenia
Ewa	Ewka, Ewcia, Ewunia	Eve
Ewelina	Ewelinka, Ewka, Ewcia, Ewunia	Evelyn
Fabiola	Fabiolka, Fabia	Fabienne
Faustyna	Faustynka	Faustina
Franciszka	Frania	Frances, Francine
Gabriela	Gabrysia, Gaba, Gabusia, Gabcia, Gabi	Gabriella, Gabrielle
Genowefa	Genia, Genka	Genevieve, Genoveva
Grażyna	Grażynka, Graża, Grażka	Grace
Halina	Halinka, Hala	Helen
Hanna	Hania, Hanka, Hanusia, Haniusia, Haneczka	Hannah
Hedwiga	Hedzia, Hedwisia	Hedwig
Helena	Helenka, Hela, Helcia	Helen
Henryka	Henrysia, Henia	Harriet, Henrietta
Ilona	Ilonka, Ila	Ilona, Helen
Irena	Irenka, Irka	Irene
Iwa	Iwunia, Iwcia	Iva
Iwona	Iwonka, Iwa, Iwka, Iwcia	Yvonne
Izabela	Iza, Izunia, Bella	Isabella
Jadwiga	Jadzia, Jadwisia, Wiga, Wisia	Hedwig
Janina	Janka, Janeczka	Jane, Jean, Jeannine
Joanna	Asia, Aśka, Joasia, Joaśka	Joan, Joanna, Joanne
Jolanta	Jolka, Jola	Iolanthe, Yolanda
Józefa	Józia, Ziuta	Josepha
Józefina	Józefinka, Józia, Józka	Josephine
Judyta	Judytka, Judysia	Judith, Judy
Julia	Julka, Julcia, Jula	Julia, Julie
Justyna	Justynka, Justysia, Justa	Justine
Kaja	Kajka	Kay, Kaya
Kalina	Kalinka	 
Kamila	Kamilka, Kama	Camilla
Karina	Karinka, Karin	Karen
Karolina	Karolinka, Karolka, Karolcia, Lola	Caroline
Katarzyna	Kasia, Kaśka, Katarzynka, Kasieńka, Kasiunia	Catherine, Katharine
Kasandra	Kasia, Kasa	Cassandra
Kazimiera	Kazia	Casimira
Kinga	Kinia, Kingusia	 
Klara	Klarusia, Klarcia	Clare, Claire
Klaudia	Klaudusia, Klaudyna	Claudia
Klementyna	Klementynka	Clementine
Kornelia	Nela, Nelka, Kora	Cornelia
Krystyna	Krystynka, Krysia, Kryśka	Christine
Ksenia	Ksenka, Oksana	Xenia
Kunegunda	Kinia, Kunda, Kundzia, Gunda	Cunegond, Cunegund
Laura	Laurentynka	Laura
Lidia	Lidka, Lidzia	Lydia
Lilia	Lilka, Lila	Lilli, Lilly
Liliana	Lilka, Lilianka, Lila	Lillian
Linda	Lindzia	Linda
Lucyna	Lucia, Lucynka	Lucine
Ludmiła	Ludka, Miłka	Ludmilla
Ludwika	Ludka, Ludzia	Louise
Luiza	Luzia	Louise
Łucja	Łusia, Łucka, Lusia	Lucy, Lucia
Magdalena	Magda, Madzia, Magdalenka, Magdusia	Magdalen
Maja	Majka, Majeczka	May
Malina	Malinka, Malka	 
Malwina	Malwinka, Malwa	Melvine
Małgorzata	Gosia, Gośka, Małgosia, Małgośka	Margaret/Maggie
Maria	Marysia, Marynia, Maryś	Mary, Maria
Marianna	Mańka, Mania, Marianka	Marian, Marianne
Marietta	Marietka, Maria, Marysia	Marietta
Mariola	Mariolka	Mariel
Marlena	Marlenka	Marlene
Marta	Martunia, Martusia	Martha
Martyna	Martynka, Martysia	Martine
Maryla	Marylka	Marilyn
Maryna	Marynka, Marynia	Marina
Marzena	Marzenka	Marion
Melania	Mela, Melka	Melanie
Michalina	Misia, Michasia	Michelle
Mirosława	Mira, Mirka	 
Monika	Monia, Mona	Monica
Nadia	Nadi	Nadia, Nadya
Nadzieja	Nadziejka, Nadia	Nadezda, Nadya, Hope
Natalia	Natka, Nati	Natalie
Natasza	Nastka, Nati, Tasza	Natasha
Nikola	Niki, Nika	Nicole
Nina	Ninka	Nina
Odeta	Odetka, Oda, Odet	Odette
Olga	Olgusia, Ola	Olga
Oliwia	Oliwka, Ola	Olive, Olivia
Otylia	Otylka, Oti, Tola,	Odile
Pamela	Pamelka, Pama, Pam	Pamela
Patrycja	Pati, Patka	Patricia
Paula	Paulinka	Paula
Paulina	Paula, Paulinka	Pauline
Pelagia	Pela, Pegi	Pelagia
Ramona	Rama	Ramona
Renata	Renia, Renatka	Renée
Regina	Reginka, Rena	Regina
Roksana	Roksanka	Roxane
Rozalia	Rózia, Rozalka	Rosalie
Róża	Rózia, Różyczka	Rose
Ruta	Rucia, Rut	Ruth
Sabina	Sabinka, Sabcia	Sabine
Samanta	Samka, Sam	Samantha
Sandra	Sandrusia, Sandrynka	Sandra
Sara	Sarcia, Sarusia	Sarah
Siennę, Sienny, Siana	Sienna
Stanisława
Stasia	Stacy
Stefania	Stefcia	Stephanie
Sylwia	Sylwka, Sylwunia, Sylwcia	Sylvia, Silvia
Szarlota	Szarlotka, Lotka	Charlotte
Świętosława	Świętosia, Tosia, Sława	 
Tamara	Tamarka, Tam, Tama	Tamara, Tammy
Tatiana	Tatianka, Tania	Tatiana, Tanya
Teodora	Dorcia	Theodora
Teresa	Tereska	Theresa
Urszula	Ula, Ulka, Usia	Ursula
Violetta	Violka	Violet
Walentyna		Valentina
Wanda	Wandzia	Vanda, Wanda
Wanessa	Waneska, Wania	Vanessa
Wera		Vera
Weronika	Wera, Werka, Nika	Veronica
Wiara		Vera, Faith
Wiera		Vera
Wiesława	Wiesia, Wieśka	vele = 'great' + sław = 'famous, glory, renown'  
Wiktoria	Wika, Wiki	Victoria
Wilhelmina	Wilka, Wila	Wilma, Wilhelmina
Wioleta	Wiola, Wioletka	Violet
Wirginia	Wiga, Wirgin	Virginia
Wisława	Wisia	 
Zdzisława	Zdzisia, Zdzicha	 
Zenobia	Zenia	Zenobia
Zofia	Zosia, Zośka, Zosieńka	Sophie
Zuzanna	Zuzanka, Zuza	Susan
Zygfryda	Zyga, Fryda, Frydzia	Sigfride
Zyta	Zytka	Zita
Żaklina	Żaklinka	Jacqueline
Żaneta	Żanetka, Żanet	Janet, Jeanette
Żywia	Żywka, Żywa	Siwa